  F 200,200,200
               SO   ./textures/South.xpm  
WE ./textures/West.xpm
     EA     ./textures/East.xpm
NO         ./textures/North.xpm
 C   100,100,100

11111111
1E000001
11111101
11111111
