  F 200,200,200
               SO   ./textures/South.xpm  
WE ./textures/West.xpm
     EA     ./textures/East.xpm
NO         ./textures/North.xpm
 C   100,100,100

1111
1S01
1001
1001
1011
1001
1001
1111