C   225,245,15
EA     ./textures/East.xpm
NO         ./textures/North.xpm
  
WE ./textures/West.xpm
  F      20    ,     100    ,         100
           SO   ./textures/South.xpm

1111
111111111111111111111111111111111 1111111
        1000000000110000000000001 1000001
        1011000001110000000000001 1111111
        1001000000000000000000001
1111 11110110000011100000000000N1
100011100001100000111111111111111
11110111111111011100000010001
11110111111111011101010010001
11000000110101011100000010001
10000000000000011000000100001
10000000000000001101010010001
1100000111010101111101111000111
11110111 1110101 101111010001
11111111 1111111 111111111111
11111111111111111111111111111
1111111 111